111111111111111
100CP000C00CFE1
111111111111111