111111111111
1P0000000001
110001111001
100001000001
100000000001
100111110001
100000010001
100111100001
101000C01001
100011110001
1E0000000001
111111111111