11111111111111111111
1G0000000G00000000G1
10000100100010000001
10110101110101110C01
1000010C000100000001
10110111011101110101
10100G00000000000101
1C101110111011101001
10001000100010001001
10101011101011101001
10000000100C00000001
10111101100111011101
10100C01000100010001
10001111101110111001
1G000C0000G100000G01
10110111011101110101
10000000000C00010001
1P110101110101101101
1E000000000000000001
11111111111111111111