1111111111111111
1E00000000000G01
1P00000000000C01
1111111111111111