1111111111111111111111111111111
1P0000100100000C000000000001001
1111001001001111111111001111001
1000000000000000001000000000001
1111111001111001111001111111001
100000100000100100000100C001001
1111001001111001001111001111001
1000001001001001000001001000001
1111001001001001111111001111001
1C01001001000C00001000000000001
1001001111001111111001111111001
1000001000001000001001001001001
1001111111001001111001001001111
1000001001001000001001000000001
1111001001001001001111001001111
1000001000000001001000001000001
1001111111111001001001111001001
100C000001000001000001001001001
1111001111111001111001001111111
100C000000000001000000000000001
1000000000000001000000010000CE1
1111111111111111111111111111111