1111111111111111
1E0G000000000G01
1110111111110111
10000C0G00C00001
1G001111111100G1
1000000000000001
1111111C11111111
1G000000P00000G1
1111111C11111111
1000000000000001
1G001111111100G1
10000C0G00C10001
1110111111110111
1G000000000000G1
1111111111111111