111111111
1000G0001
1000G0001
1000G0001
1000G0001
11GCG00P1
100000001
1000G00E1
1000G0001
111111111