111111111111111111111
1P0000000000000000001
110001111111111110001
100001000000000000001
100000C00000000000001
100111111111111110001
100000010000000000001
101110111111111111101
1010C0000000000001001
100011111111111110001
10000000000000000C001
101111011111111111101
10100000000C000000001
100001111111111111001
100000000000000000001
100111111111111111101
100000000000000000001
1C0011111111111111001
1E0000000000000000001
111111111111111111111