111111111111111111111111111111111111111111
100000000000000000000000000000000000000001
101111111111111111111111111111111111111101
100000000000000000000000000000000000000001
1000000000G0000000G000000000G0000000001101
100000000000000000000000000000000000000001
100000000000000000000000000000000000000001
100000000000000000000000000000000000000001
100000000000000000000000000000000000000001
100000000000000000000000000000000000000001
100000000000000000000000000000000000000001
100000000000000000000000000000000000000001
101111111111111111111111111111111111PCE101
100000000000000000000000000000000000000001
111111111111111111111111111111111111111111