111111111111111111111111
10CG01C1010000C001010101
101001011000001001011001
1C000CCCC0000C000CCCC001
101001001000001001001001
100101001111001111C00001
11100G010G00011110G01111
10C00101010000C001010101
101000011000G01000P11001
1C0G0C0CC00G0C000C0CC001
101001001000001001001001
11111110011G011111100111
10C0010101G000C001010101
101001010000001001010001
1C0G0CC000G00C000CC00G01
1E1001001000001001001001
100G001110000000000G0001
10000G0000010000000G0001
111111111111111111111111
